# Glossary in tab-separated format -*- coding: utf-8 -*-
riassettare	assetiai	it. rassettare, fr. arranger, sp. remmendar
paralitico	màrturu
lettuccio	letera	lètiga, lètia
glorificare	alabantzai	allabantzai; alabai
discepolo	discipulu
pubblicani	pubblicanus
discepoli	discìpulus	scientis
chiamare	circai   (ca Gesùs est circhendi is discìpulus)
messagero	nùntziu
messaggero	nùntziu
davanti a te	ananti tuu
raddrizzate	aparixai	aderetzai
sentieri	àndalas	moris
predicando	predichendi
battesimo	batiari
conversione	cunversioni	pentimentu
Accorreva	acudiat	aprobiàt
Dopo di me	infatu miu
sciogliere	scapiai
prediletto	prus stimau
compiaciuto	cumpraxu
sospinse	impertu
quaranta	coranta
Subito dopo	luegus
arrestato	tentu
compiuto	cumpriu
convertitevi	cunvertei·sì
riassettavano	assetiendi
seguirono	postu infatu
proprio	etotu	pròpiu
insegnare	donai imparu	imparu de Gesus
si mise a gridare	si peseit a boxis
rovinarci	si nci portai a sa perditzioni
straziandolo	trumentedi·ddu
strappare	stoddiri
permesso	permìtiu
si trovò nel bisogno	si fiat agatau in su bisòngiu
i campi di grano	is trigus
i pani dell'offerta	is panis de s'oferta
il sommo sacerdote	su predi mannu
strappare	arrancai	stoddiri
Perciò	po cussu	tantis chi
inaridita	cancarada	sica in campidanesu si imperat po làngia, asciuta
inaridita	cancarada	retenta; sica
guardandoli	ponniri su càstiu
osservavano	poniant su càstiu
al vangelo	in s'avangèliu
permesso	lìtzitu
Gerusalemme	Gerusulamme
Gerusalemme	Gerusalemmi
parabole	paràbbulas	paràbbolas
resistere	durai	aguantai
annunziava	annuntziàt
secondo	cunforma
spiegava	spricàt
stelo	canna
mietitura	s'ora de messai	su tempus de messai
Fate attenzione	Ponei atentzioni	Donai a cura/Giai a cura
l'accolgono	dd'arricint
seminatore	seminadori	massaju
l'accolgono	dd'acollint	dd'arricint
Iscariota	Iscariòtu	Iscariota
si ribella	s'arrebbellat	si furriat
messo in luce	scoviau	postu a craru
si voltò	si fiat furriau
emorragia	pèrdiri sànguni
vantaggio	profetu
peggiorando	andendi de mali in peus
alle sue spalle	a palas de issu
l'indemoniato	su spiridau
misericordia	làstima
proclamare	annuntziai
si precipitò	nci fiat spentumau
non tormentarmi!	no mi trumentis!
si percuoteva	pistendi·sì	ferrendi·sì
Che hai tu in comune con me	Lassa·mì in paxi	Ita ses circhendi·mì
al quale	a chini
obbediscono	ponint menti
infranto	struncau
Giunsero	Arribbaus	Lòmpius
Strepito	Atropèlliu	Avolotu
Carpentiere	Fusteri	Maistu de linna
Viaggio	Biaxi	Viàgiu, Caminu
Giuramento	Giura	Giuramentu; Promissa
sordomuto	surdu
pregandolo	preghendi·ddu	impetrendi·ddu
imporgli	ddi impònniri
si sciolse	si ddi fiat snuada
correttamente	comenti si spetat
E comandò loro di non dirlo a nessuno	E ddus iat pretzetaus a no narai nudda a nemus
voleva che nessuno lo sapesse	no boliat a ddu sciri nemus
nascosto	cuau
figlioletta	fillixedda
non è bene	no est bonu
cagnolini	calleddus
briciole	farinalla
Per questa tua parola	Po su chi as narau
intenzioni cattive	intentus malus
fornicazioni	lussùria
calunnia	disfama
malvagità	malesa
adultèri	adultèriu
cupidigie	asurìmini
impudicizia	discaru	disonestadi
contamina	imbrutat
Dal di dentro	De aintru
dal di fuori	de parti de foras
veramente abili	bonus diaderus
sia messo a morte	siat cundennau a morti
annullando	torrendi a nudda
precetti	pretzetus
di uomini	umanus	de is òminis
mi rendono	mi torrant
mi onora	mi torrat onori
traversata	traessada
approdarono	iant aprodau
accorrendo	aproillendi
lettucci	lètigas	letèras
campagne	sartu
guarivano	fiant sanaus
la frangia del mantello	s'oru de su manteddu
pregavano	pregànt	impetrànt
indurito	tostau
non temete	no timais
li ebbe congedati	nci ddus iat dispidius
fantasma	pantàsima	pantuma
erano rimasti turbati	si fiant assustraus
l'ultima parte della notte	a coa de noti
accorrere	aprobiai	aproillai
congedali	dispidi·ddus
solitario	spèrdiu
riposatevi	pasiai·sì
gli riferirono	dd'iant torrau a contai
Giovanni il Battista	Giuanni su Batista
giuramento	impromissa	giura
commensali	cumbidaus
cadavere	corpus
sepolcro	tumba	sepurcru
Chiedimi	Pedi·mì
giorno propizio	dii bona
i grandi	is majoris
notabili	autoridadis
sapendolo	connoscendi·ddu
perplesso	dudosu
dai morti	de mesu a is mortus
miracoli	miràculus
Elia	Elias	Allias, Elia
decapitare	degollai
risuscitato	torrau a biu	arrisuscitau
era diventato famoso	fiat essiu famau
guarivano	sanànt
ungevano	ungiant	poniant ollu
rimanetevi	abitai·ddoi	abarrai·ddoi
testimonianza	testimonia
insegnando	donendi imparu
si scandalizzavano	ndi iant tentu scàndulu
disprezzato	dispretziau
nella sua patria	in logu suu
tra i suoi parenti	in is de domu
incredulità	pagu fidi
Ioses	Ioses	Giusepi
carpentiere	fusteri	maistu de linna
sapienza	sabidoria
grande stupore	spantu mannu
cacciati tutti fuori	boghendi·nci totus a foras
bambina	pipia	piciochedda
fanciulla	piciochedda	pipia
sii guarita	sanada siast
impaurita e tremante	timendi e tremendi
digiunare	giaunai
digiunano	funt giaunendi
invitati	cumbidaus
Si recarono	andant
stavano facendo	megànt
peccatori	pecadoris
lo seguì	dd'iat postu in fatu
li ammaestrava	ddis donàt s'imparu
Si trasfigurò	trasfigurau
splendenti	arreluxenti
bianchissime	biancu che nii
lavandaio	lissieri
renderle così bianche	torrai innidu aici
spavento	timoria
li avvolse	ddus iat imboddiaus
ascoltatelo	ascurtai·ddu
lo afferra	dd'aferrat
lo getta	nci ddu scudit
al suolo	a terra
digrigna	tzichirriat	tzacarrat
si irrigidisce	s'acirdinat
è possibile	est dabbili
per	a	po
ad alta voce	a boxi manna	a boxis
scuotendolo	scutulendi·ddu	santzinendi·ddu
fortemente	a forti
se ne uscì.	ndi ddi fiat essiu
se non con	sceti cun
preghiera	pregadoria
scacciarlo	nci ddu bogai
in privato	a una parti
Istruiva	fiat donendi imparu	istrutzionàt
nelle mani	in is manus
risusciterà	at a arrisuscitai
chiedergli spiegazioni	ndi ddi preguntai
accoglie	arricit	aberit is bratzus
possa parlare male di me	potzat fueddai mali de mei	mi potzat calunniai
ricompensa	arrecumpènsia
bicchiere	tassa
scandalizza	est de scàndulu	strunciat, criticat, ofendit, brigat
con il fuoco	a fogu
senza sapore	bambu	sciapidu
ciascuno	ònniunu
con un occhio solo	bisogu
ti scandalizza	t'ofendit
taglialo	sega·ti·nde·ddu
inestinguibile	chi no studat
lo salerete	dd'eis a cundiri
Ecco		Alloddu
fiume		arriu
cintura		singeddu
degno		dìnniu
Spirito		Spìridu
venne		fiat lòmpiu
vangelo		evangèliu
spirito		spìridu
pregava		pregàt
venuto		bènniu
parola		paràula
folla		truma
uomo		òmini
otri		urdis
come		comenti cumenti
strada		caminu
a lui		a innui fiat issu
degno		dinnu
Spirito		Spirìdu
Inizio		Cumintzu
preparate	preparai apariciai
legacci		corrias
sandali		sàndulus
cielo		celus
tentato		tenteau
satana		satanassu
angeli		àngiulus
regno		rennu
vicino		acanta
credete		ponei fidi
subito		in deretura
garzoni		giorronaderis
Taci		Calla·tì a sa muda
scribi		scribas
Vedi		mirai
sotto		in su tempus
sommo		mannu o majori
signore		sennori
fianchi		chintzu
diranno		ant a narai
senapa		alaussa
ortaggi		ortalìtzia
pronto		cumpriu
misura		medida
moggio		moju
parola		paràula
gioia		prexu
perché		aici chi, po chi
Dodici		Doxi
radice		arrexinis
tempesta di vento	traschia, frusada
a poppa		a pupa
Chi ha orecchi per intendere intenda	Ascurtit chini portat origas po ascurtai Intendat chini portat origas po intendiri
pietre		arrocas
Giàiro		Giàiru
Diceva		creiat
fede		fidi
attorno		a fùrriu
sii		siast
medici		mèigus
scongiuro	pedu, domandu
spirito immondo		spìridu malu
sepolcri	tumbas,sepulcrus
catene		cadenas
ceppi		trabas
timore		timoria
Re		Rei
Guardia		Buginu
lo raccomandava	si ddu pretzetàt
in disparte	a parti
sospiro		sùlidu
trovò		iat agatau
figli		fillus
Partito di là	De innia
mondi		in puresa
dall'uomo	de s'òmini, de sa personi
uomini		òminis
furti		furas
omicidi		mortis
inganno		trassas, traitorias
superbia	barrosìmini
stoltezza	machìmini
invidia		fèngia
uomo		òmini
fogna		latrina
perché		ca
contaminarlo	imbrutai, cundiri
intendete bene	circai de cumprèndiri
Trascurando	Scabudendi, Lassendi
osservate	poderais, sigheis
degli uomini	de is òminis, umanu
eludere		arrefudai
tradizione	traditzioni, connotu
maledice	maleixit, frastimat
dichiara	decrarat, narat
offerta		oferta
permettete	permiteis, lassais
Invano		Sbòdiu
culto		cultu
lontano		atesu
da me		de mei
labbra		larbas, laras
popolo		pòpulu
venuti		lòmpius
stupiti		spramaus, spantaus
Coraggio	Ànimu, Coràgiu
cessò		si fiat firmau
Ordinò		Iat cumandau
mentre		in s'interis
remare		arremai
cominciarono a gridare	si fiant pesaus a boxis
gruppi		trumixeddas
verde		frisca
ceste		cadinus
Andate		Baxei
come		che
tardi		trigadiu
per		peri
testa		conca
vassoio		safata
piacque		ddi fiat agradèssia
a causa		po mori
lecito		lìtzitu
vigilava	teniat in contu, teniat a càstiu
si convertisse	si fessit cunvertia, a si cunvertiri
bastone		bàculu
viaggio		viàgiu
polvere		prùini
piedi		peis
sabato		sàbudu
alzati		pesati·ndi
è morta		s'est morta
cuce		arrangiat
toppa		tzàpulu
strappo		scòrriu
versa		ghetat
nozze		coja
Ora		Immoi
medico		mèigu
malati		malàdius
banco delle imposte	bangu de is tributus
Seguimi		Beni cun megus
Maestro		Su Maistu, Rabbi
tende		pinnetas, umbragus, barracas
è bello		est una cosa bona
nube		nui
nessuno		nemus
posseduto	portat,	est possidiu
muto		mudu
schiuma		bogat spuma
Credo		Giai creu, Deu creu
specie		genia
che alcuno lo sapesse	chi dd'apat scìpiu nemus, a ddu sciri nemus
timore		timoria
colui		su chi
nel mio nome	in nòmini miu/ a nòmini miu
Non glielo proibite	No si ddu proibbais
Chiunque	Chini totu
da bere		a bufai
meglio		mellus
salato		saliu
cavalo		boga·ti·nde·ddu
Geenna		inferru
con		a
zoppo		tzopu
monco		manuncau
collo		tzugu
Transgiordania	addia de / addei de
paragonare	cumparai/ pònniri a pari
tacevano	Abarrànt citius	a sa muda
È fuori di sé	At pèrdiu su sentidu	Est foras de sei
satana	satanassu	sàtana
ne saccheggerà	ddi at a sdorrobbai sa domu
bestemmie	frastimai	ghetai frastimu
pronto	cumpriu	drimpiu
si mette mano	si ghetat
non aveva da mangiare	chene nudda de papai	no portànt cosa de papai
sfamarli	po ndi bogai su fàmini	po pràndiri
portarono via	si ndi fiant pigaus	si ndi iant pigau
Dalmanùta	Dalmanùta	Dalmanuta?
con sé		cunsegus
Convocata	tzerriendi
Va' in pace	Bai in paxi
medici	dotoris
salvato	sanau	sarvau
cieco	tzurpu
gettato via	scavulendi·nci
Coraggio	toca
mendicare	pèdiri limòsina
pietà	làstima
lo sgridavano	ddu certànt
Giacomo	Giacu
servitore	serbidori
calice	càlixi
destra	dereta
sinistra	manca
concederlo	ddu acansai
bere	tastai	bufai
che io faccia	a fàiri deu
consegnato	at a èssiri intregau
sacerdoti	sacerdotus majoris
lo scherniranno	si nd'ant a befai
gli sputeranno addosso	dd'ant a spudai
lo flagelleranno	dd'ant a aciotai
presso	anca de
la cruna	s'ogu
afflitto	scorau
tesoro	arrichesa manna
Non uccidere	No bòcias
adulterio	adultèriu
non frodare	no fatzas trampa
lettucci	stojas
indurito	intostau
stupiti	spramaus
fatto	fau	miràculu
Coraggio	ànimu	coràgiu
subito	luegus
precederlo	andai a innantis
licenziato	dispidiu
sul mare	asuba de mari
contrario	contras
l'ultima parte della notte	a coa de noti
gruppi	trumas	trumixeddas, trupas
verde	frisca	birdi
si sfamarono	si fiant pràndius
sedettero	si fiant stèrrius
tardi	trigadiu	tardu
si riunirono	si fiant assodius
Venite	Ajo cun mimi
un po'	una scuta	pagu·pagu
divenne triste	si fiat intristau
guardia	guàrdia	buginu
lo decapitò	dd'iat degollau
Qualsiasi	calisisiat
chiedere	pediri
il giorno propizio	sa dii bona
banchetto	cumbidu
risuscitato	torrau biu
bisaccia	bèrtula
carpentiere	maistu de linna
monte degli Ulivi	monti de is olias
villaggio	bidda
asinello	molenteddu
nessuno è mai salito	no dd'at mai sètziu nemus
sciogliendo	scapiendi
Scioglietelo	ndi ddu scapiais
conducetelo	ndi ddu bèteis
lo rimanderà	ndi dd'at a torrai a mandai
vi montò sopra	dd'iat sètziu
stendevano	sterriant
fronde	fròngia
Osanna<t0/> nel più alto dei cieli!	Osanna in is celus prus artus
seguente	infatu
ebbe fame.	dd'iat pigau fàmini
fico	figu
foglie	folla
stagione	tempus
scacciare	nci bogai
rovesciò	nci iat furriau
cambiavalute	cambiadinai
spelonca	gruta	cuili
ladri	furonis	brigantis
ammirato	ammirau
Quando venne la sera	A scurigadroxu
maledetto	maleixu
abbiate fede	tenei fidi	cunfiai in Deus
 In verità vi dico	In beridadi bosi naru
contro	contras a	cun
anziani	mannus
dal cielo	de Deus
Non sappiamo	No ddu scieus
Tutti ti cercano	totus funt circhendi·tì	Totus ti circant
stese	allonghiau	stèrriu
un'apertura	trapa	stampu
lettuccio	stoja
 ti ordino	ti cumandu	ti seu narendi
otri	udris
lecito	litzizu	contras a sa lei
sommo sacerdote	sacerdotu majori
Mettiti nel mezzo	poni·tì in mesu
Stendi	allonghia
perché non lo manifestassero.	ca no boliat a scoviai	ca no boliat a ndi bogai cun nemus
costituì	nominau
rese	iat donau	iat betiu
si abbattono	imbruchinant	si storrant
moggio	imbudu	moju
Se uno ha orecchi per intendere, intenda!	Se uno ha orecchi per intendere, intenda!
se	chi	si
Salì	iat pigau	nci fiat pesau/artziau
ceppi	trabas	travas/tzipus
cielo	is celus	celu
Effatà	Efatà
arrisuscitau	arresuscitai
accade	acuntèssiri
contro	contras
Cafarnao	Cafarnau	Cafàrnau
si radunarono	si fiant pinnigadas apari
 Ora	Tandus
altrimenti	deghinò, desinuncas
camminando	in caminu
lecito	lìcitu
Betsàida	Betsàida
Cesarèa	Cesarea
con sé	infatu
Elia	Elias
subito	totuinduna
posseduto	portat unu spiridu
convulsioni	si giogai
minacciò	iat ammeletzau
non si estingue	est fitianu
Giudea	Giudea
Giordano	Giordanu
Gerico	Gèricu
Bartimèo	Bartumeu
Timèo	Timeu
Davide	Dàvidi
Gesù Nazareno,	Gesùs su Nazarenu
Bètfage	Bètfage
monte degli Ulivi,	Monti de is Olias
Cesare	Cèsari
Betània	Betània
veritiero	beridadosu
non ti curi	no ndi fais contu
